##################
#]$$$$$$$$#$$$$$##
#]$###$$$$$$$$$#$#
#$$#%$@$$$$#$$$$&#
#$$#$$$$#$##$$]]$#
#$$###$$#$#$$$$###
#$$$$]]$#$#$$$$$$#
#$$##$$$$$##$$####
#$$$#$$#$$$$$$#$$#
#$$$#&$#$$$#$$#$$#
#$$##$$#####$$$$$#
#$$]$$$$$#$$$$]]$#
#$##$$$$##$####$$#
#$#$$##$$$$#$&#$$#
#$#$&##$$$$#$$$$$#
##################