################
#$$$##$$..###$$#
###$$$$#..###..#
#$$$$$##$$$....#
#$&$#######.$###
##....##$$$$$###
#$$$$#$$$$$$$..#
#$$$$#@#####..##
###$$#.#$$$$.###
%$$$$$$##$$&...#
################