##################
#&$$$$$$#$$$#$$$%#
#$$$#$$$$$$$#$$$$#
#$##############$#
#$$$#$$$$$$$#$$$&#
#$$$$$$$#$$$$$$$$#
#$########$$######
#$$$.$$$#$$$$$$$$#
###$.$$$######$$##
#@$$#$$$#$$$$$$$$#
##################