########################
#@$#$$$$$]$$&$$$$$$$#$!#
#$$#$$#$]]$$$####$$$#]&#
#$$$$$#$$$$$$#$#$$$$$]$#
#$]]$$####$$$#$#$$$###$#
#$$#$$#$$]$#$#$###$$$$$#
#$$#$$$$$]####$$$$$$]###
#&$#$#####$%$#$&$$$$]$$#
#$$#$]$$$$$$$$$$$###$$$#
#$##$]$$$##]]##$$$$$$$&#
#$$$$###$$$#$$$#$$$$]$$#
###$$$$]$$$#$$$$#$$$#$$#
#$]$#$$]$$###$$$$$$$#$$#
#$]$$##$$$$#$$$$$]]]##$#
#!&$$$$$$$$]$$$$$$$$#!$#
########################