##################
##$$$$$$$.$$$$$$.#
#$#$$&$$$#$$$$$#$#
#$$#$$$$$#$$$$#$$#
#$$$#$$$$#$$$#$$$#
#$$$$#$$$#$$#$$&$#
#$$$$$.$$#$#$$$$$#
#.######%######..#
#$$$$#$&$#$$#$$$$#
#$$$#$$$$#$$$#$$$#
#$$#$$$$$#$$$$#$$#
#@#$$$$$$#$$$$$.$#
##$$$$$$$.$$&$$$##
##################